111111111
100000001
10P000001
100111001
100101001
100111001
10C000E01
100000001
111111111
