111111111111111
100010000000001
10P0000C0000001
100011011110101
100010000010001
10C0100C0010C01
100000000010001
101011110110001
100000000010001
1000000C0000E01
111111111111111
