1111111111111111111111111111111
1000001000001000001000001000001
1000000000001000001000000000001
100A00000C00000000000C00000A001
1000000000001000001000000000001
1000001000001000001000001000001
1111111111111111111111111111111
