11111111111111111111
10000010000100100001
100P0000000100000001
10000000C000C0000001
10000000000100010E01
10000010000100000101
11111111111111111111
