111111111111111111
100000100001001001
100P00000001000001
10000000C000C00001
1000000000010010E1
100000100001000011
111111111111111111
